24 15 0 150
4  4  4  4  4  4  4  4  4  4  4  4  4  4  4  4  4  4  4  4  4  4  4  4  4  4  4  4  4  4  4  4  4  4  4  4  4  4  4  4
4 10  8  6  6  8  6 10 10  8  6  8  8  8 10  6 10  8  8 10  8  8  8  8  6  8  8  8 10  8  8  8  8  8 10  6  8  9  8  4
4  8  8  0  6  8  9  8 10  8  6  8  8  8  6  6  6  8  8  6  8 10  8  8  8  8 10  8  8 10  8 10  8  8  8  6  8  6 10  4
4  8  8  8  8  6  8  8 10  9  8  8 10  8  8  8  8  6  8  8  8  8  8 10  8  6  6 10  8  8  8  8  8  8  8  6  8  6  6  4
4  9  8  6  8  8  6 10  6 10  8  8 10  8  8  8  8  6  8  8  8 10  8  8  8  8  8  8 10  8 10 10  8  8  8  8  8  8  6  4
4 10  8  6  8  8  8  6  8  8 10  8  6  6  8  8 10  8  6  6  9  8  8  8  8  8  8  8 10  8 10 10  8  8  8  8  8  8  6  4
4 10 10  8  8 10  8  8  8  8  6  8  8  8 10  8  8  8  8  8  8 10  8 10 10  8  8  8  8  8  8 10  8  8  9  6  6  8  8  4
4  8  8 10  8  6  6  8  8 10  8 10 10  8  8  8  6  8  8  8  8 10  8 10 10  8  8  8  8  8  8  6  8  8 10  8  6  8 10  4
4  8  8  6  8  8  8  9  8  8  8  8  8  8  9  8 10  8  8  6  6 10  8  8 10  8  6  8  6 10  8  8  6 10  8  8  9  8 10  4
4 10  8 10  8  8  8  8  6  8  6  6  8  8  9  8 10  8  8  6  6 10  8  8 10  8  8  9  8  6  8  8  8  6  8  8 10  8  6  4
4  8 10  8  6  6  8  8  8  8  8 10 10  6 10  8  8  9  8  6  8  6 10  8  8  6 10  8  8  8  6 10  8  8  9  8 10  8  8  4
4  6  8  6  6  8  8  8  8  8  8 10 10  6 10  8  8 10  8  6  8  6  6  8  8  8  6  8  8 10  8  6  6  8  8 10  8  6  6  4
4  8  6  8 10  8 10  8  6  8  8  8  6  6 10  8  8 10  8  8  8  8  6  8  8  8 10  8  8  8  8  8  6  6  8 10  8  6  6  4
4  8  6  8 10  8 10  8  6  8  9  8  6  8  6 10  8  8  6 10  8  8  8  8 10  8  8 10  8 10 10  8  8  8  8  6  8  8  8  4
4  6  8  8  6 10  6 10  8  8 10  8  8  8  8  6  8  8  8  9  8  8  8  6  8 10  6  8  8  8  8  8  8  6  8  6  6  8  9  4
4  6  8  8  8  6  6 10  8  8  6  8  9  8  8  8  6 10  8  8 10  8 10  8  8  8 10  8  6 10  8  8  8  8  8  8  6  8  8  4
4  6  8  9  8  8  8  8 10  8  6  6  8  8 10  8  6  6 10  8  8  8  8  8  8  8 10  8  6 10  8  8  8  8  8  8  6  8  8  4
4  8  8 10  8  8  8  8  6  8  8  8 10  8  8  8  8  8  8 10  8 10 10  8  8  8  8  8  8  6  8  8 10  8  6  8  8  8  6  4
4 10  8  6  6  8  8 10  8  6  6  8  8  8  6  8  8  8  8 10  8 10 10  8  8  8  8  8  8  6  8  8 10  9  8  8 10  8  8  4
4  6  8  8  8 10  8  8  8  8  8  8 10  8 10  9  8  8  8  8  8  8 10  8  8  8  6  6  8  8  6 10  8  8  9  8  6  8  8  4
4 10 10  8  8  8  6  8  8  8  8  8 10  8 10  9  8  8  8  8  8  8  6  8  8 10  8  6  9  8  9  8 10  6  8 10  8  8  8  5
4  4  4  4  4  4  4  4  4  4  4  4  4  4  4  4  4  4  4  4  4  4  4  4  4  4  4  4  4  4  4  4  4  4  4  4  4  4  4  4
36 5 20 120
4  4  4  4  4  4  4  4  4  4  4  4  4  4  4  4  4  4  4  4  4  4  4  4  4  4  4  4  4  4  4  4  4  4  4  4  4  4  4  4
4  0  8  8  8  8  8 10  8  8  8  8  8  8  8  8  8  8  8  8  8  8  8  8  8  8  8  8 10  8  8  8  8  8  8  8  8 10  8  4
4  8  8  8  8  8 10  8  8  8  8  8  8  8  8  8  8  8  8  8  8 10  8  8  8  8  8  8  8  8  8  8  8  8  8  8  8  8  8  4
4  8  8  8  8  8  8  8  8 10  8  8 10  8  8  8  8  8  8  8  8  8  8  8  8  8  8  8  8  8  8  8  8  8  8  8  8  8  8  4
4 10  8  8  8  8  8  8  8  8  8  8  8  8  8  8  8  8  8  8  8  8  8  8  8  8  8  8  8  8  8  8  8  8  8  8  8  8  8  4
4  8  8  8  8  8  8  8  8  8  8  8  8  8  8  8  8  8  8  8 10  8  8  8  8  8  8  8  8  8  8  8  8  8  8  8  8  8  8  4
4  8 10  8  8  8  8  8  8  8  8  8  8  8  8  8  8  8  8  8  8  8  8  8 10  8  8  8  8  8  8  8  8  8 10  8  8  8  8  4
4  8  8 10  8  8  8  8  8 10  8  8  8  8  8  8  8  8  8  8  8 10  8  8 10  8  8  8  8  8  8  8  8  8  8  8  8  8 10  4
4  8  8  8  8  8  8 10  8  8  8  8  8  8 10  8  8  8  8  8  8  8  8  8  8  8  8  8  8  8  8  8  8  8  8  8 10  8  8  4
4  8  8  8  8  8  8  8  8  3 12  8  8  8 10  8  8  3 12  8  8  8  8  8  8  3 12  8  8  8  8  8  8  3 12  8  8  8  8  4
4  8  8  8  8  8  8  8  8  3  3  8  8  8 10  8  8  3  3  8  8  8  8  8  8  3  3  8  8  8  8  8  8  3  3  8 10  8  8  4
4  8  8  8  8  8  8  8  8  8  8  8  8  8  8  8  8  8  8  8  8  8  8  8  8  8  8  8  8  8  8  8  8  8  8  8  8  8  8  4
4  8  8  8 10  8  8  8  8  8  8  8  8  8  8  8  8  8  8  8  8  8  8  8  8  8  8  8  8  8  8  8  8  8  8 10  8  8  8  4
4  8  8  8 10  8  8  8  8  8 10  8  8  8  8  8  8  8  8  8  8  8  8  8  8  8  8  8  8  8  8  8  8  8  8  8  8  8  8  4
4  8  8  8  8  8  8 10  8  8  8  8  8  8  8  8  8  8  8 10  8  8  8  8  8  8  8  8  8  8  8  8  8  8  8  8  8  8 10  4
4  8  8  8  8  8  8  8  8  8  8  8 10  8  8  8  8  8  8  8 10  8  8  8  8  8  8  8  8  8  8  8  8  8  8  8  8  8  8  4
4  8  8 10  8  8  8  8  8  8  8  8  8  8  8  8  8  8 10  8  8  8  8  8  8  8  8  8  8  8  8  8  8  8  8  8  8  8  8  4
4  8  8  8  8  8  8  8  8  8  8  8  8  8  8  8  8  8  8  8  8  8 10  8  8  8  8  8  8  8  8  8 10  8  8  8  8  8  8  4
4  8  8  8  8  8  8  8  8  8  8  8  8  8  8  8  8  8  8  8  8  8  8  8  8  8  8  8  8  8  8  8  8 10  8  8 10  8  8  4
4  8  8  8  8 10  8  8  8  8  8  8 10  8 10 10  8  8  8  8  8  8  8  8  8  8  8  8  8  8  8  8  8  8 10  8  8  8  8  4
4  8  8  8  8  8  8  8  8  8  8  8 10  8 10 10  8  8  8  8  8  8  8  8  8 10  8  8 10  8 10  8  8  8  8  8  8  8  5  4
4  4  4  4  4  4  4  4  4  4  4  4  4  4  4  4  4  4  4  4  4  4  4  4  4  4  4  4  4  4  4  4  4  4  4  4  4  4  4  4
15 10 20 120
4  4  4  4  4  4  4  4  4  4  4  4  4  4  4  4  4  4  4  4  4  4  4  4  4  4  4  4  4  4  4  4  4  4  4  4  4  4  4  4
4  8  3  8  8  3  8 10 10  8  8  8  8  8  3  8  8 10  8  3  0  8  8  8  8  3 10 10  3 10  8  8 10  8  3  8  3  3  8  4
4  3  8  8 10  8  3  8  8  3  8  3  3  8  8  8  8  3  8 10  8 10  8  3  8  8  8  3  3 10  8  8 10  8  9  8  8  3  8  4
4 10  8  8  8  8  8  3  3  8 11  8  3  3  8  8  8  3  8 10  8 10  8  3  8  8  8  3  6  6  6  6  6  6  6  6  6  6  6  4
4  8 10  8  9  8  8  8  3  8  3  3  8  8  8  8  8  8  3  8  8 10 10  8  8 10  8  8  8  8  3  8  3  8  8  8  3  8  3  4
4  6  6  6  6  6  6  6  6  6  6  6  6  8 10  8  3  8  8  3  3  3 10  8  8  3  8  8  8  8  3  8  8  8 10  8  8  8  8  4
4 10  8  3 10  8  8  8  8  8  8  3  8  8 10  8  3  8  8  8  3  8  8 10  8  3  3  8  8 10  8  3  3 11  8  8  8  8  8  4
4 10  8  3 10  8  8  8  8  8  8  3  8  8  3 10  8  8 10  8  8  8  8  3  8  8  8 10  8  8  8  8  8  8 10  8 10 10  8  4
4  8  8  8  3  8  8 10  3  3  8  8  8  3  8  8 10  8  3  3  8  8 10  8  3  3  8  8  8  3  8  8  8  8 10  8 10 10  8  4
4  8  8  8  3  8  8 10  8  3  8 10  8  8  8  8  3  8  8  8 11  8  8  8  8  8  8 10  8 10  8  8  3  3 10  8  8 10  8  4
4  3  3  8  8  3 10  8  8  8  8  3  8  8 10  8 10  8  8  8  8  3  8  3  3  8  8  8  8  8  8  8  3  3  9  8  8  3  8  4
4  8  3  8  8  8  3  8  8  3  8  3  3  8  8  3  8  3  3  8  8  8  8  8 10 10  3 10  8  8 10  8  3  8  3 10  8  8  3  4
4  8  8  3  9  8  8 10  8 10  8  8  8  8  3  8  3  3  8  8  8  8  8  8 10  3  3 10  8  8 10  8  3  8  3  3  8  8  8  4
4  8 10  8  3  3  8  8 10  8  3  3  8  8  8  3  8 10  8 10  8  3  8  8  8  3  3 10  8  8  3  8  8  8  8  3  8  8  8  4
4  8  8  8  8  3  3  8 10  8  3  3  8  8  8  3  8 10  8 10  8  3  8 10  8  3  8  3 10  8  8  3 10  8  8  8  8  3  8  4
4  8  3  3  8  8  8  8  3  8  8  8  8  3  3  8  8  3 10  3 10  8  8 10  8  8  8  8  3  8  8  8 10  8  8  8  3  8 10  4
4  8  8  8  8  8  3  8  3  3  8 10 10  8  3  8  8  8  3  3 10  8  8  3  8 10  8  8  8  3 10  8  8 10  8 10  8  8  8  4
4  3 10  8  8  8  8  8  8  3  8  8 10  8  3  8 10  8  8  8  8  3  8  3  3  8  8 10  8  3  3 10  8  8  8  8  8  8  8  4
4  3 10  8  8  8  8  8  8  3  8  8  3 10  8  8 10  8  8  8  8  3  8  8  8 10  8  8  8  8  8  8 10  8 10 10  8  8  8  4
4  8  3  8  8 10  8  3  8  8  8  3  8  8 10  8  3  3  8 13 13  8  3  3  8  8  8  3  8  8  8  8 10  8 10 10  8  8  8  4
4  8  3  8  9 10 11  8  8 10  8  8  8  8  3  8  8  8 10  8  8  8  8  8  8 10  8 10 11  8  8  8  8  8  9 10  8  8  8  5
4  4  4  4  4  4  4  4  4  4  4  4  4  4  4  4  4  4  4  4  4  4  4  4  4  4  4  4  4  4  4  4  4  4  4  4  4  4  4  4
75 5 19 150
4  4  4  4  4  4  4  4  4  4  4  4  4  4  4  4  4  4  4  4  4  4  4  4  4  4  4  4  4  4  4  4  4  4  4  4  4  4  4  4
4  9  9  9 10 10  9  9 10  9  9 10  8 10 10 10 10  9 10  9  9  8  9  9 10  9  9 10  9  9  9  9 10 10  9 10  9 10 10  4
4  9 10 10  9  9  9 10 10 10  9 10  9  9 10 10 10 10 10 10  9 10 10  9  8  9 10  9 10 10 10 10  9 10  9  9 10 10  9  4
4  9  9 10 10 10 10 10 10 10  9 10  9  9 10 10  8 10 10 10  9 10 10  9  9  9 10  9 10  8 10 10  9 10 10 10  9  9 10  4
4 10 10  9 10  9  9 10 10 10 10 10 10  9 10 10  9  9  9  8  8  9  9 10 10  9 10  9  9 10 10  9 10  9  9  8 10 10  9  4
4 10 10  9 10  9  9 10 10 10 10 10 10  9 10 10  9  8  9 10  9 10 10 10 10  9 10  9 10  9 10 10  9  9 10 10  9 10  9  4
4  9  9  9 10 10  9 10  9  8  9  9 10 10  9  9 10 10  9  9  9 10 10  9 10  9 10 10 10  8  9 10  9  9 10 10  9 10  9  4
4 10 10 10 10 10  9 10 10  9  9  9  9  8  8 10 10 10  9 10  9  9  8 10  9 10  9  9 10  8 10 10  9  9  9  9  9  9 10  4
4  9 10  9  9  6  6  6  6  6  6  6  8  6  6  6  6  6  9 10 10 10 10  9 10  6  6  6  6  6  6  8  6  6  6  6  6  6 10  4
4  9  8  9  9  6  3  3  3  3  3  3  3  3  3  3  3  6 10  9  9 10 10 10  9  6  3  3  3  3  3  3  3  3  3  3  3  6 10  4
4  9 10  9 10  6  3  0  5  3  3  3  3  3  3  3  3  6 10  9  9 10 10 10  9  6  3  3  3  3  3  3  3  3  3  3  3  6 10  4
4  9 10 10  9  6  3  3  3  3  3  3  3  3  3  3  3  6 10  8 10 10  9  9 10  6  3  3  3  3  3  3  3  3  3  3  3  6 10  4
4  9 10 10  9  6  3  3  3  3  3  3  3  3  3  3  3  6  9  9  9  9 10  9 10  6  3  3  3  3  3  3  3  3  3  3  3  6  9  4
4 10  9  9  9  6  3  3  3  3  3  3  3  3  3  3  3  6  9 10 10  9  8  9 10  6  3  3  3  3  3  3  3  3  3  3  3  6  9  4
4 10 10 10 10  6  3  3  3  3  3  3  3  3  3  3  3  6  9 10 10  9  9 10 10  6  3  3  3  3  3  3  3  3  3  3  3  6 10  4
4  9 10  9  9  6  3  3  3  3  3  3  3  3  3  3  3  6  8 10  9 10 10  9 10  6  3  3  3  3  3  3  3  3  3  3  3  6 10  4
4  9 10  9  9  6  3  3  3  3  3  3  3  3  3  3  3  6  6  6  6  6  6  6  6  6  3  3  3  3  3  3  3  3  3  3  3  6 10  4
4 10 10 10  9  6  3  3  3  3  3  3  3  3  3  3  3  3  3  3  3  3  3  3  3  3  3  3  3  3  3  3  3  3  3  3  3  6 10  4
4 10 10 10  9  6  3  3  3  3  3  3  3  3  3  3  3  6  9  9  8 10  9 10  9  6  3  3  3  3  3  3  3  3  3  3  3  6 10  4
4  9  9 10 10  6  3  3  3  3  3  3  3  3  3  3  3  6 10 10 10  9 10  9  9  6  3  3  3  3  3  3  3  3  3  3  3  6 10  4
4  9  9  8  8  6  6  6  6  6  6  6  6  6  6  6  6  6  9 10 10 10  9  9  9  6  6  6  6  6  6  6  6  6  6  6  6  6  9  4
4  4  4  4  4  4  4  4  4  4  4  4  4  4  4  4  4  4  4  4  4  4  4  4  4  4  4  4  4  4  4  4  4  4  4  4  4  4  4  4
12 25 60 150
4  4  4  4  4  4  4  4  4  4  4  4  4  4  4  4  4  4  4  4  4  4  4  4  4  4  4  4  4  4  4  4  4  4  4  4  4  4  4  4
4  8  8  8  8  8  8  8  8  8  8  8  8  0  8  8  8  8  8  8  8  8  8  8  8  8  8  8  8  8  8  8  8  8  8  8  8  8  8  4
4  6  6  6  6  6  6  6  6  6  6  6  6  3  6  6  6  6  6  6  6  6  8  8  8  8  8  8  8  8  8  8  8  8  8  8  8  8  8  4
4  6  8  8  8  8  9  8  8  8  8  8  8  8  8  8  8  8  8  8  9  6  8  8  8  8  8  8  8  8  8  8  8  8  8  8  8  8  8  4
4  6  8  6  3  6  8  6  6  6  6  6  6  3  6  6  6  6  6  6  8  6  8  8  8  8  8  8  8  8  8  8  8  8  8  8  8  8  8  4
4  6  8  6 11  6  8  6  9  8  8  8  8  8  8  8  8  8  9  6  8  6  8  8  8  8  8  8  8  8  8  8  8  8  8  8  8  8  8  4
4  6  8  6 11  6  8  6  8  6  6  6  6  3  6  6  6  6  8  6  8  6  8  8  8  8  8  8  8  8  8  8  8  8  8  8  8  8  8  4
4  6  8  6 11  6  8  6  8  6  9  8  8  8  8  8  9  6  8  6  8  6  8  8  8  8  8  8  8  8  8  8  8  8  8  8  8  8  8  4
4  6  8  6 11  6  8  6  8  6  8  6  6  3  6  6  8  6  8  6  8  6  8  8  8  8  8  8  8  8  8  8  8  8  8  8  8  8  8  4
4  6  8  6 11  6  3  6  3  6  3  6  3  3  3  6  3  6  3  6  3  6  8  8  8  8  8  8  8  8  8  8  8  8  8  8  8  8  8  4
4  6  8  6 11  6 11  6 11  6 11  6 11 11 11  6 11  6 11  6 11  6  8  8  8  8  8  8  8  8  8  8  8  8  8  8  8  8  8  4
4  6  8  6 11  6  3  6  3  6  3  6  3  3  3  6  3  6  3  6  3  6  8  8  8  8  8  8  8  8  8  8  8  8  8  8  8  8  8  4
4  6  8  6 11  6  8  6  8  6  8  6  6  6  6  6  8  6  8  6  8  6  8  8  8  8  8  8  8  8  8  8  8  8  8  8  8  8  8  4
4  6  8  6 11  6  8  6  8  6  9  8  8  8  8  8  9  6  8  6  8  6  8  8  8  8  8  8  8  8  8  8  8  8  8  8  8  8  8  4
4  6  8  6  9  6  8  6  8  6  6  6  6  6  6  6  6  6  8  6  8  6  8  8  8  8  8  8  8  8  8  8  8  8  8  8  8  8  8  4
4  6  8  6  9  6  8  6  9  8  8  8  8  8  8  8  8  8  9  6  8  6  8  8  8  8  8  8  8  8  8  8  8  8  8  8  8  8  8  4
4  6  8  6  9  6  8  6  6  6  6  6  6  6  6  6  6  6  6  6  8  6  8  8  8  8  8  8  8  8  8  8  8  8  8  8  8  8  8  4
4  6  8  6  9  6  9  8  8  8  8  8  8  8  8  8  8  8  8  8  9  6  8  8  8  8  8  8  8  8  8  8  8  8  8  8  8  8  8  4
4  6  6  6  6  6  6  6  6  6  6  6  6  6  6  6  6  6  6  6  6  6  8  8  8  8  8  8  8  8  8  8  8  8  8  8  8  8  8  4
4  8  8  8  8  8  8  8  8  8  8  8  8  8  8  8  8  8  8  8  8  8  8  8  8  8  8  8  8  8  8  8  8  8  8  8  8  8  8  4
4  8  8  8  8  8  8  8  8  8  8  8  8  8  8  8  8  8  8  8  8  8  8  8  8  8  8  8  8  8  8  8  8  8  8  8  8  8  8  5
4  4  4  4  4  4  4  4  4  4  4  4  4  4  4  4  4  4  4  4  4  4  4  4  4  4  4  4  4  4  4  4  4  4  4  4  4  4  4  4
6 50 0 120
4  4  4  4  4  4  4  4  4  4  4  4  4  4  4  4  4  4  4  4  4  4  4  4  4  4  4  4  4  4  4  4  4  4  4  4  4  4  4  4
4 10  8 10  9  8 10 10 10  8  6  8  8  8  9 10 10  8  8 10  6  8  8  8  9  8  8  8 10  8  6  8  8  8  9 10  8 10  8  4
4  8  8  8  3  8 10  8 10  8  6  8  8  8 10  3 10  8  8 10  6 10  8  8  8  8 10  8  8 10  6 10  8  8  8 10  8 10 10  4
4  8  8  8  8  3  8  8 10 10  6  8 10  8  8  8  8 10  8  8  6  8  8 10  8  3 10 10  8  8  6  8  8  8  8 10  8 10 10  4
4 10  8 10  8  8  3 10 10 10  6  8 10  8  8  8  8  3  8  8  6 10  8  8  8  8  8  8 10  8  6 10  8  8  8  8  8  8 10  4
4 10  8  3  8  8  8 10  8  8  6  8  3  3  8  8 10  8 10 10  6  8  8  8  8  8  8  8 10  8  6 10  8  8  8  8  8  8  3  4
4 10 10  8  8 10  8  8  8  8  6  8  8  8 10  8  8  8  8  8  6 10  8 10 10  8  8  8  8  8  6 10  8  8 10  3 10  8  8  4
4  8  8 10  8 10 10  8  8 10  6 10 10  8  8  8 10  8  8  8  6 10  8 10 10  8  8  8  8  8  6 10  8  8 10  8  3  8  6  4
4  8  8 10  8  8  8 10  8  8  6  8  8  8 10  8 10  8  8 10  6 10  8  8 10  8  3  8 10 10  6  8  3 10  8  8 11  6 10  4
4 10  8 10  8  6  6  6  6  6  6  6  6  6 11  6  6  6  6  6  6  6  6  6 10  6  6  6  6  6  6  6  6  6  8  8  6  8  3  4
4  8 10  8  3  3  8  8  8  8  8 10 10 10 10  8  8 10  8 10  8 10 10  8  8 10 10  8  8  8  3 10  8  8 10  6 10  8  8  4
4 10  8 10 10  8  8  8  8  8  8 10 10 10 10  8  8 10  8  3  8  3 10  8  8  8 10  8  8 10  8 10 10  8  6 10  8 10 10  4
4  8  3  8 10  8 10  8  3  6  8  8 10 10 10  8  8 10  8  8  8  8  3  8  8  8 10  8  8  8  8  8 10  6  8 10  8 10 10  4
4  8  3  8 10  8 10  8  3  6  3  8  6  6  6  6  6  6  6  6  6  6  6  6  6  6  6  6  6 10 10  8  6  8  8 10  8  8  8  4
4 10  8  8  3 10 10 10  8  6 10  8  8  8  8 10  8  8  8 10  8  8  8  3  8 10 10  8  8  8  8  6  8 10  8 10 10  8 10  4
4 10  8  8  8 10 10 10  8  6 10  8 10  8  8  8  3 10  8  8 10  8 10  8  8  8 10  8 10 10  6  8  8  8  8  8 10  8  5  4
4  3  8 10  8  8  8  8 10  6  3  3  8  8 10  8 10 10 10  8  8  8  8  8  8  8 10  8 10  6  8  8  8  8  8  8  3  8  8  4
4  8  8 10  8  8  8  8  3  6  8  8 10  8  8  8  8  8  8 10  8 10 10  8  8  8  8  8  6 10  8  8 10  8 10  8  8  8 10  4
4 10  8 10 10  8  8 10  8  6 10  8  8  8 10  8  8  8  8 10  0 10 10  8  8  8  8  8  8 10  8  8 10 11  8  8 10  8  8  4
4 10  8  8  8 10  8  8  8  6  8  8 10  8 10 11  8  8  8  8  8  8 10  8  8  8  3 10  8  8  3 10  8  8 10  9 10  8  8  4
4 10 10  8  9  8  3  8  8  6  8  8 10  8 10 10  8  8  8  8  8  8 10  8  8 10  8  3 10  8 11  8 10 10  8 10  8  8  8  4
4  4  4  4  4  4  4  4  4  4  4  4  4  4  4  4  4  4  4  4  4  4  4  4  4  4  4  4  4  4  4  4  4  4  4  4  4  4  4  4
19 20 0 180
4  4  4  4  4  4  4  4  4  4  4  4  4  4  4  4  4  4  4  4  4  4  4  4  4  4  4  4  4  4  4  4  4  4  4  4  4  4  4  4
4 10  8  3  8  8  8 10 10  8  8  8  8  8 10  8 10  8  8 10  8  8  8  8  8  8  8  8 10  8  8  8  8  8 10  8  8  9  8  4
4  8  8  8  8  8  9  8 10  8  8  8  8  8  8  8  3  8  8  8  8 10  8  8  8  8 10  8  8 10  8  8  8  8  8  3  8  8 10  4
4  8  8  8  8  8  8  8 10  9  6  8 10  8  6  8  8  3  6  8  8  8  6 10  8  8  8 10  8  8  8  3 11  8  8  3  8  8  3  4
4  9  6  6  6  6  6  6  6  6  6  6  6  8  6  8  8  8  6  8  8 10  6  8  8  8  8  8 10  8  8  3  3  8  8  8  8  8  8  4
4 10  8  8  8  8  8  8  8  8  6  8  8  8  6  8 10  8  6  3  9  8  6  8  8  8  8  8 10  8  8  8  8  8  8  8  8  8  8  4
4 10 10  8  8 10  8  8  8  8  6  8  8  8  6  8  8  8  6  8  8 10  6 10 10  8  8  8  8  8  8 10  8  8  9  8  8  8  8  4
4  8  8 10  8  8  8  8  8 10  6 10 10  8  6  8  8  8  6  8  8 10  6 10 10  8  8  8  8  8  8  8  8  8 10  8  8  8 10  4
4  8  6  6  6  6  6  6  6  6  6  6  6  8  6  8 10  8  6  3  8 10  6  8 10  8  8  8  8 10  8  3 11  8  8  8  9  8 10  4
4 10  8 10  8  8  8  8  8  8  6  8  8  8  6  8 10  8  6  8  8 10  6  8 10  8  8  9  8  8  8  3  3  8  8  8 10  8  8  4
4  8 10  8  8  8  8  8  8  8  6 10 10  3  6  8  8  9  6  8  8  3  6  8  8  8 10  8  8  8  8  8  8  8  9  8 10  8  8  4
4  3  8  8  8  8  8  8  8  8  6 10 10  3  6  8  8 10  6  8  8  8  6  8  8  8  3  8  8 10  8  8  8  8  8 10  8  8  8  4
4  8  6  6  6  6  6  6  6  6  6  6  6  6  6  6  6 10  6  8  8  8  6  8  8  8 10  8  8  8  8  8  8  8  8 10  8  3  3  4
4  8  8  8 10  8 10  8  8  8  6  8  8  8  6 10  8  8  6 10  8  8  6  8 10  8  8 10  8 10  8  3 11  8  8  8  8  8  8  4
4  8  8  8  8 10  3 10  8  8  6  8  8  8  6  8  8  8  6  9  8  8  6  8  8 10  3  8  8  8  8  3  3  8  8  8  8  8  9  4
4  8  8  8  8  3  8 10  8  8  6  8  9  8  6  8  8 10  6  8 10  8  6  8  8  8 10  8  3 10  8  8  8  8  8  8  8  8  8  4
4  8  6  6  6  6  6  6  6  6  6  6  6  8  6  8  8  8  6  8  8  8  6  8  8  8 10  8  3 10  8  8  8  8  8  8  8  8  8  4
4  8  8 10  8  8  8  8  8  8  6  8 10  8  6  8  8  8  6 10  8 10  6  8  8  8  8  8  8  3  8  8 10  8  8  8  8  8  8  4
4 10  8  0  8  8  8 10  8  3  6  8  8  8  6  8  8  8  6 10  8 10  6  8  8  8  8  8  8  8  8  8 10  9  8  8 10  8  8  4
4  8  8  8  8 10  8  8  8  8  6  8 10  8  6  9  8  8  6  8  8  8  6  8  8  8  8  3  8  8  8 10  8  8  9  8  3  8  8  4
4 10 10  8  8  8  8  8  8  8  6  8 10  8  6  9  8  8  6  8  8  8  6  8  8 10  8  8  9  8  9  8 10  8  8 10  8  8  8  4
4  4  4  4  4  4  4  4  4  4  4  4  4  4  4  4  4  4  4  4  4  4  4  4  4  4  4  4  4  4  4  4  4  4  4  4  4  4  4  4
50 5 8 160
4  4  4  4  4  4  4  4  4  4  4  4  4  4  4  4  4  4  4  4  4  4  4  4  4  4  4  4  4  4  4  4  4  4  4  4  4  4  4  4
4 10  8  8  8  8  8 10 10  8  5  8  8  8  8  8 10  8  0 10  13  8  8  8  8  8  8  8 10  8  8  8  8  8  8  8  8 10  8  4
4  8  8  8  8  8 10  8 10  8  8  8  8  8  8  8  8  8  8  8  8 10  8  8  8  8 10  8  8 10  8 10  8  8  8  8  8  8  8  4
4  8  8  8  8  8  8  8  8 10  8  8 10  8  8  8  8  8  8  8  8  8  8  8  8  8  8 10  8  8  8  8  8  8  8  8  8  8  8  4
4 10  8  8  8  8  8  8  8 10  8  8  8  8  8  8  8  8  8  8  8 10  8  8  8  8  8  8 10  8  8 10  8  8  8  8  8  8  8  4
4 10  8  8  8  8  8  8  8  8 10  8  8  8  8  8 10  8  8  8 10  8  8  8  8  8  8  8 10  8  8 10  8  8  8  8  8  8  8  4
4  8 10  8  8 10  8  8  8  8  8  8  8  8 10  8  8  8  8  8  8 10  8 10 10  8  8  8  8  8  8  8  8  8 10  8  8  8  8  4
4  8  8 10  8  8  8  8  8 10  8  8  8  8  8  8  8  8  8  8  8 10  8 10 10  8  8  8  8  8  8  8  8  8 10  8  8  8 10  4
4  8  8  8  8  8  8 10  8  8  8  8  8  8 10  8 10  8  8  8  8 10  8  8 10  8  8  8  8  8  8  8  8 10  8  8 10  8  8  4
4 10  8 10  8  8  8  8  8  8  8  8  8  8 10  8 10  8  8  8  8  8  8  8  8  8  8 10  8  8  8  8  8  8  8  8  8  8  8  4
4  8  8  8  8  8  8  8  8  8  8 10 10  8 10  8  8 10  8  8  8  8 10  8  8  8 10  8  8  8  8 10  8  8 10  8 10  8  8  4
4  8  8  8  8  8  8  8  8  8  8 10  8  8 10  8  8 10  8  8  8  8  8  8  8  8  8  8  8 10  8  8  8  8  8 10  8  8  8  4
4  8  8  8 10  8 10  8  8  8  8  8  8  8 10  8  8  8  8  8  8  8  8  8  8  8 10  8  8  8  8  8  8  8  8 10  8  8  8  4
4  8  8  8 10  8 10  8  8  8 10  8  8  8  8 10  8  8  8 10  8  8  8  8  8  8  8 10  8  8  8  8  8  8  8  8  8  8  8  4
4  8  8  8  8 10  8 10  8  8 10  8  8  8  8  8  8  8  8 10  8  8  8  8  8 10  8  8  8  8  8  8  8  8  8  8  8  8 10  4
4  8  8  8  8  8  8 10  8  8  8  8 10  8  8  8  8 10  8  8 10  8 10  8  8  8  8  8  8 10  8  8  8  8  8  8  8  8  8  4
4  8  8 10  8  6  6  6  6  6  6  6  6  6  6  6  6  6  6  6  6  6  6  6  6  6  6  6  6  6  6  6  6  6  6  8  8  8  8  4
4  8  8 10  8 12 12 12 12 12 12 12 12 12 12 12 12 12 12 12 12 12 12 12 12 12 12 12 12 12 12 12 12 12 12  8  8  8  8  4
4 10  8  8  8 10 10 10 10 10 10 10 10 10 10 10 10 10 10 10 10 10 10 10 10 10 10 10 10 10 10 10 10 10 10  8 10  8  8  4
4  8  8  8  8  8  8  8  8  8  8  8  8  8  8  8  8  8  8  8  8  8  8  8  8  8  8  8  8  8  8  8  8  8  8  8  8  8  8  4
4  8 10  8  8  8  8  8  8  8  8  8  8  8  8  8  8  8  8  8  8  8  8  8  8  8  8  8  8  8  8  8  8  8  8 10  8  8  8  4
4  4  4  4  4  4  4  4  4  4  4  4  4  4  4  4  4  4  4  4  4  4  4  4  4  4  4  4  4  4  4  4  4  4  4  4  4  4  4  4
30 10 20 150
4  4  4  4  4  4  4  4  4  4  4  4  4  4  4  4  4  4  4  4  4  4  4  4  4  4  4  4  4  4  4  4  4  4  4  4  4  4  4  4
4  8  8  0  8  8  8  8  8  8  8  8  8  8  8  8  8  8  8  8  8  8  8  8  8  8  8  8  8  8  8  8  8  8  8  8  8  8  8  4
4  8  8  8  8  8  8  8  8  8  8  8  8  8  8  8  8  8  8  8  8  8  8  8  8  8  8  8  8  8  8  8  8  8  8  8  8  8  8  4
4  8  8  8  8  8  8  8  8  8  8  8  8  8  8  8  8  8  8  8  8  8  8  8  8  8  8  8  8  8  8  8  8  8  8  8  8  8  8  4
4  8  8  8  8  8  8  8  8  8  8  8  8  8  8  8  8  8  8  8  8  8  8  8  8  8  8  8  8  8  8  8  8  8  8  8  8  8  8  4
4  8  8  8  8  8  8  8  8  8  8  8  8  8  8  8  8  8  8  8  8  8 11  8 11  8 11  8 11  8 11  8 11  8  8  8  8  8  8  4
4  8  8  8  8  8  8  8  8  8  8  8  8  8  8  8  8  8  8  8  8  8 10  8 10  8 10  8 10  8 10  8 10  8  8  8  8  8  8  4
4  8  8  8  8  8  8  8  8  8  8  8  8  8  8  8  8  8  8  8  8  8  8  8  8  8  8  8  8  8  8  8  8  8  8  8  8  8  8  4
4  8  8  8  8  8  8  8  8  8  8  8  8  8  8  8  8  8  8  8  8  8  8  8  8  8  8  8  8  8  8  8  8  8  8  8  8  8  8  4
4  8  8  8  8  8  8  8  8  8  8 12  8  3  8  3  8  3  8  3  8  3  8  8  8  8  8  8  8  8  8  8  8  8  8  8  8  8  8  4
4  8  8  8  8  8  8  8  8  8  8  3  8  3  8  3  8  3  8  3  8  3  8  8  8  8  8  8  8  8  8  8  8  8  8  8  8  8  8  4
4  8  8  8  8  8  8  8  8  8  8  3  8 12  8  3  8  3  8  3  8  3  8  8  8  8  8  8  8  8  8  8  8  8  8  8  8  8  8  4
4  8  8  8  8  8  8  8  8  8  8  3  8  3  8  3  8  3  8  3  8  3  8  8  8  8  8  8  8  8  8  8  8  8  8  8  8  8  8  4
4  8  8  8  8  8  8  8  8  8  8  3  8  3  8 12  8  3  8  3  8  3  8  8  8  8  8  8  8  8  8  8  8  8  8  8  8  8  8  4
4  8  8  8  8  8  8  8  8  8  8  3  8  3  8  3  8  3  8  3  8  3  8  8  8  8  8  8  8  8  8  8  8  8  8  8  8  8  8  4
4  8  8  8  8  8  8  8  8  8  8  3  8  3  8  3  8 12  8  3  8  3  8  8  8  8  8  8  8  8  8  8  8  8  8  8  8  8  8  4
4  8  8  8  8  8  8  8  8  8  8  3  8  3  8  3  8  3  8  3  8  3  8  8  8  8  8  8  8  8  8  8  8  8  8  8  8  8  8  4
4  8  8  8  8  8  8  8  8  8  8  3  8  3  8  3  8  3  8 12  8  3  8  8  8  8  8  8  8  8  8  8  8  8  8  8  8  8  8  4
4  8  8  8  8  8  8  8  8  8  8  3  8  3  8  3  8  3  8  3  8  3  8  8  8  8  8  8  8  8  8  8  8  8  8  8  8  8  8  4
4  8  8  8  8  8  8  8  8  8  8  3  8  3  8  3  8  3  8  3  8 12  8  8  8  8  8  8  8  8  8  8  8  8  8  8  8  8  8  4
4  8  8  8  8  8  8  8  8  8  8  8  8  8  8  8  8  8  8  8  8  8  8  8  8  8  8  8  8  8  8  8  8  8  8  8  8  8  8  5
4  4  4  4  4  4  4  4  4  4  4  4  4  4  4  4  4  4  4  4  4  4  4  4  4  4  4  4  4  4  4  4  4  4  4  4  4  4  4  4
15 10 20 120
4  4  4  4  4  4  4  4  4  4  4  4  4  4  4  4  4  4  4  4  4  4  4  4  4  4  4  4  4  4  4  4  4  4  4  4  4  4  4  4
4 10  8 10 10  8  8  3  3 10  8  8 10  8  8 10  8 10  8  8  0 10  8  8 10  8 10 10  8  8 10  8 10 10  8  8  8 10  8  4
4  8  6  8 10 10  8  8  8  8  8  8 10  8  8 10  8  8  8 10  8  8  8  8  6  8  8  8 10  8  8  8  8  8  8 10  8 10  8  4
4 10 10  6  8 10  8  8  8  3 10  8  8  3 10  8  8 10  8 10  8  8 10  6 10  8  8  8  8  3  8  8  3  8  8 10  8 10 11  4
4  8  8  8  6 10  8  8 10  8  3 11  8  8  8  8  8 10  8  3  8  8  6 10  8  3  3  8  8  8  8  8 10 10 10 10  8  8 10  4
4  8 10 10  8  6 10 10  8  8  8  3 10  8  8 10  8 10  8  8  8  6 10  8  3 10  8  8  8  8  8  8 10 10 10 10  8  8 10  4
4  8  3 10  8  8  6 10  8  8 10  8 10  3  8  8 10  8 10 10  6  8  8  8  3 10 10 10  8  3  8  8  8 10 10 10  8  8 10  4
4  8  8  8 10 10  8  6  8  3 11  8  8 10  8  8 10  8 10  6  8  8  8  8  8 10  8 10 10  8  8 10  8 10  8 10 10  8  8  4
4  8  8 10  8 10  8  8  6  8 10 10  8  8  8  8  3  8  6  8  8  8 10  8  8  3 10 10 10  8  8 10  8  8  8  8 10  8  8  4
4  8  8  8  3  8 10 10  8  6  8  8  8  8 10  8  3  6 11 10 10  8  3  8  8  8 10 10 10  8  8 10  8 10  8  8  8  3 10  4
4 10  8 10  8  8  8 10  8 10  6  8  8  8  8  8  6 10  8  8 10  8  3  8 10  8  8  8  8 10  8  3  3  8  8 10  8 10 10  4
4  8  8  8  8  8  8 10  8 10 10  6  8  8  8  6  8  3  8  8 10 10  8  8 10  8  8  8  8  3  8  8  8 10  8  8  8  8  8  4
4  8 10 10  8  8  8  8  8  8 10  8  8  8  8 10  8  8  8 10  8  8 10  8 10  3  8  8 10  8 10 10  8  8  8  3 10  8  8  4
4  8 10 10  8  8  8  8  8  8 10  8  7  7  7  8  8 10  8  8  8  8 10  8  8  8 10  8  8  8  8  8  8 10  8 10 10  8  8  4
4  8  8 10  8  8  8  3 10  8  8  8 10  8  8 10  8 10  8  8 10  8 10 10  8  8  8  3  8  8  8  8  8 10  8 10 10  8  8  4
4  8  8 10  8  8 10  8  3  8 10  8  8  8  8 10  8  8  8  8  8 10  8  3  3  8  8  8  8  8  8 10 10 10  8  8 10  8  3  4
4 10  8  8  3 10  8  8  8  8 10  8  8 10  8 10  8  8  8  8 10  8  3  3  8  8  8  8  8  8  8 10 10 10  8  8 10  8  8  4
4 10  8  8  8 10  8  8 10  8  3  3  8  8 10  8  3  3  8  8  8  8  3 10 10 10 10  8  8 10  8 10  8 10 10  8  8 10 10  4
4  8  3 10  8  8 11  3 10  8  8  8  8 10  8 10 10  8  8  8  8  8  8 10 10 10 10  8  8 10  8  3  8 10 10  8  8  3 10  4
4 10  8 10 10  8  8 10  8 10 10  8  8  8  3  8 10  8 10  8  3  8  8  8 10 10 10  8  8 10  8  8  8  8  3  8  8  8 10  4
4  8  8  8 10 10  8 10  8 10 10  8  8  8  3  8 10  8 10  8  P  8  8  8 10  3 10  8  8 10  8 10  8  8  8  8 10  8  8  5
4  4  4  4  4  4  4  4  4  4  4  4  4  4  4  4  4  4  4  4  4  4  4  4  4  4  4  4  4  4  4  4  4  4  4  4  4  4  4  4
cristaisobjetivo cristaispontos cristaispontosextras tempo
_ENTRANCE   0
_PLAYER     1
_TARDIS     2
_AIR        3
_IRON       4
_EXIT       5
_BRICK      6
_ECHTBRICK  7
_DIRT       8
_CRISTAL    9
_BOULDER    10
_SQUARE     11
_BUTTERFLY  12
_AMOEBA     13
_EXPLOSION  14
_CEXPLOSION 15